NOC,Year,Bronze,Gold,Silver,total_count,region
GRE,1896,20,10,18,48,Greece
GBR,1896,3,3,3,9,UK
DEN,1896,3,1,2,6,Denmark
AUT,1896,2,2,1,5,Austria
AUS,1896,1,2,0,3,Australia
USA,1896,2,11,7,20,USA
HUN,1896,3,2,1,6,Hungary
SUI,1896,0,1,2,3,Switzerland
FRA,1896,2,5,4,11,France
GER,1896,2,25,5,32,Germany
CUB,1900,0,1,1,2,Cuba
LUX,1900,0,1,0,1,Luxembourg
NZL,1900,0,1,0,1,New Zealand
CAN,1900,1,1,0,2,Canada
AUS,1900,3,3,0,6,Australia
ITA,1900,0,3,2,5,Italy
NOR,1900,3,0,6,9,Norway
COL,1900,0,0,1,1,Colombia
DEN,1900,2,4,3,9,Denmark
GER,1900,11,14,20,45,Germany
USA,1900,17,30,16,63,USA
SUI,1900,1,16,4,21,Switzerland
AUT,1900,3,0,3,6,Austria
BOH,1900,2,0,1,3,Czech Republic
FRA,1900,82,52,101,235,France
GBR,1900,15,59,34,108,UK
ESP,1900,0,2,0,2,Spain
HUN,1900,2,1,2,5,Hungary
BEL,1900,13,6,24,43,Belgium
IND,1900,0,0,2,2,India
SWE,1900,1,3,0,4,Sweden
NED,1900,16,3,8,27,Netherlands
MEX,1900,3,0,0,3,Mexico
HAI,1900,0,1,0,1,Haiti
SUI,1904,2,1,0,3,Switzerland
USA,1904,125,128,141,394,USA
FRA,1904,0,0,2,2,France
CUB,1904,0,5,0,5,Cuba
GBR,1904,0,1,1,2,UK
GRE,1904,1,1,0,2,Greece
CAN,1904,12,27,9,48,Canada
NOR,1904,0,2,0,2,Norway
HUN,1904,1,2,1,4,Hungary
AUT,1904,1,2,1,4,Austria
AUS,1904,1,0,3,4,Australia
GER,1904,7,4,5,16,Germany
NED,1908,16,0,0,16,Netherlands
FRA,1908,23,12,5,40,France
BOH,1908,6,0,0,6,Czech Republic
GBR,1908,90,147,131,368,UK
ANZ,1908,2,15,2,19,Australia
BEL,1908,8,1,24,33,Belgium
RUS,1908,0,1,2,3,Russia
HUN,1908,6,7,7,20,Hungary
AUT,1908,1,0,0,1,Austria
GER,1908,6,4,11,21,Germany
DEN,1908,3,0,14,17,Denmark
NOR,1908,3,7,32,42,Norway
RSA,1908,0,1,1,2,South Africa
FIN,1908,28,1,1,30,Finland
CAN,1908,30,14,8,52,Canada
SWE,1908,18,48,18,84,Sweden
USA,1908,15,34,16,65,USA
GRE,1908,1,0,3,4,Greece
ITA,1908,0,2,6,8,Italy
USA,1912,36,46,25,107,USA
SWE,1912,25,103,62,190,Sweden
SUI,1912,0,2,0,2,Switzerland
GER,1912,23,11,19,53,Germany
NOR,1912,34,40,6,80,Norway
GRE,1912,1,1,0,2,Greece
DEN,1912,33,5,49,87,Denmark
FRA,1912,5,10,11,26,France
HUN,1912,3,10,17,30,Hungary
CAN,1912,3,3,2,8,Canada
NED,1912,26,0,0,26,Netherlands
BEL,1912,11,7,1,19,Belgium
GBR,1912,59,47,64,170,UK
FIN,1912,22,9,40,71,Finland
RUS,1912,9,0,5,14,Russia
ANZ,1912,3,5,2,10,Australia
AUT,1912,5,0,9,14,Austria
RSA,1912,0,5,2,7,South Africa
ITA,1912,2,22,1,25,Italy
GER,1916,0,0,0,0,Germany
JPN,1920,0,0,3,3,Japan
TCH,1920,10,0,0,10,Czech Republic
CAN,1920,3,10,3,16,Canada
GRE,1920,0,0,5,5,Greece
USA,1920,38,111,45,194,USA
NOR,1920,27,58,52,137,Norway
AUS,1920,1,0,6,7,Australia
RSA,1920,6,3,12,21,South Africa
ITA,1920,8,67,9,84,Italy
DEN,1920,1,26,44,71,Denmark
GBR,1920,17,52,42,111,UK
LUX,1920,0,0,1,1,Luxembourg
ESP,1920,0,0,23,23,Spain
FIN,1920,17,21,14,52,Finland
NED,1920,25,15,10,50,Netherlands
EST,1920,0,1,2,3,Estonia
FRA,1920,57,13,71,141,France
SWE,1920,64,52,38,154,Sweden
BRA,1920,5,1,1,7,Brazil
BEL,1920,66,57,65,188,Belgium
NZL,1920,1,0,0,1,New Zealand
SUI,1920,21,6,2,29,Switzerland
TCH,1924,5,1,4,10,Czech Republic
NED,1924,18,8,1,27,Netherlands
SWE,1924,43,8,30,81,Sweden
JPN,1924,1,0,0,1,Japan
POL,1924,1,0,4,5,Poland
HUN,1924,8,2,12,22,Hungary
LUX,1924,0,1,1,2,Luxembourg
FIN,1924,18,28,21,67,Finland
HAI,1924,5,0,0,5,Haiti
AUT,1924,1,3,4,8,Austria
NEP,1924,0,1,0,1,Nepal
GBR,1924,30,31,34,95,UK
CAN,1924,1,9,19,29,Canada
DEN,1924,3,2,9,14,Denmark
RSA,1924,1,1,1,3,South Africa
GRE,1924,0,1,0,1,Greece
ITA,1924,21,25,5,51,Italy
URU,1924,0,14,0,14,Uruguay
IRL,1924,1,0,1,2,Ireland
SUI,1924,22,22,25,69,Switzerland
NOR,1924,9,18,12,39,Norway
AUS,1924,2,4,5,11,Australia
ROU,1924,16,0,0,16,Romania
EST,1924,4,1,1,6,Estonia
NZL,1924,1,0,0,1,New Zealand
YUG,1924,0,2,0,2,Serbia
IND,1924,0,7,0,7,India
MON,1924,1,0,0,1,Monaco
USA,1924,50,98,46,194,USA
ARG,1924,2,5,3,10,Argentina
BEL,1924,11,3,30,44,Belgium
FRA,1924,32,37,51,120,France
POR,1924,4,0,0,4,Portugal
EST,1928,6,2,1,9,Estonia
YUG,1928,10,1,1,12,Serbia
POL,1928,15,2,3,20,Poland
ARG,1928,5,3,18,26,Argentina
EGY,1928,1,2,1,4,Egypt
AUS,1928,1,1,2,4,Australia
RSA,1928,5,1,0,6,South Africa
LUX,1928,0,1,0,1,Luxembourg
NZL,1928,0,1,0,1,New Zealand
DEN,1928,4,6,5,15,Denmark
CAN,1928,21,19,5,45,Canada
AUT,1928,4,3,4,11,Austria
IND,1928,0,14,0,14,India
PHI,1928,1,0,0,1,Philippines
GBR,1928,25,7,27,59,UK
HAI,1928,0,0,1,1,Haiti
ITA,1928,26,24,22,72,Italy
USA,1928,19,53,30,102,USA
FRA,1928,14,14,24,52,France
JPN,1928,1,2,6,9,Japan
URU,1928,0,17,0,17,Uruguay
CHI,1928,0,0,1,1,Chile
HUN,1928,0,10,11,21,Hungary
FIN,1928,10,10,9,29,Finland
POR,1928,6,0,0,6,Portugal
NOR,1928,6,10,8,24,Norway
SUI,1928,16,16,10,42,Switzerland
NED,1928,8,20,29,57,Netherlands
ESP,1928,0,3,0,3,Spain
GER,1928,46,21,15,82,Germany
SWE,1928,23,9,21,53,Sweden
TCH,1928,3,2,12,17,Czech Republic
IRL,1928,0,1,0,1,Ireland
BEL,1928,5,0,1,6,Belgium
LAT,1932,0,0,1,1,Latvia
GBR,1932,14,9,12,35,UK
JPN,1932,4,10,17,31,Japan
NZL,1932,0,0,2,2,New Zealand
DEN,1932,4,0,7,11,Denmark
CAN,1932,29,16,14,59,Canada
IND,1932,0,15,0,15,India
RSA,1932,3,2,0,5,South Africa
BEL,1932,1,0,0,1,Belgium
IRL,1932,0,2,0,2,Ireland
URU,1932,1,0,0,1,Uruguay
AUS,1932,1,3,1,5,Australia
NOR,1932,3,3,4,10,Norway
SUI,1932,0,0,3,3,Switzerland
MEX,1932,0,0,2,2,Mexico
TCH,1932,2,1,3,6,Czech Republic
ARG,1932,0,3,1,4,Argentina
NED,1932,1,2,10,13,Netherlands
GER,1932,21,10,26,57,Germany
USA,1932,64,91,68,223,USA
ESP,1932,1,0,0,1,Spain
SWE,1932,12,14,9,35,Sweden
HUN,1932,10,20,5,35,Hungary
POL,1932,14,3,4,21,Poland
FRA,1932,6,28,8,42,France
PHI,1932,3,0,0,3,Philippines
FIN,1932,17,6,9,32,Finland
ITA,1932,18,21,38,77,Italy
AUT,1932,3,2,2,7,Austria
GBR,1936,12,24,17,53,UK
NED,1936,21,9,7,37,Netherlands
MEX,1936,16,0,0,16,Mexico
IND,1936,0,19,0,19,India
LAT,1936,1,0,1,2,Latvia
POR,1936,3,0,0,3,Portugal
YUG,1936,0,0,1,1,Serbia
NOR,1936,18,8,20,46,Norway
TCH,1936,1,5,12,18,Czech Republic
ARG,1936,4,5,2,11,Argentina
EST,1936,3,2,2,7,Estonia
NZL,1936,0,1,0,1,New Zealand
SUI,1936,24,9,29,62,Switzerland
ROU,1936,0,0,1,1,Romania
FIN,1936,16,12,8,36,Finland
HUN,1936,17,25,1,43,Hungary
JPN,1936,10,9,4,23,Japan
DEN,1936,3,0,3,6,Denmark
ITA,1936,5,37,34,76,Italy
FRA,1936,19,13,13,45,France
TUR,1936,1,1,0,2,Turkey
RSA,1936,0,0,1,1,South Africa
PHI,1936,1,0,0,1,Philippines
USA,1936,30,53,29,112,USA
CAN,1936,9,1,25,35,Canada
EGY,1936,2,2,1,5,Egypt
GER,1936,61,97,73,231,Germany
AUT,1936,9,7,44,60,Austria
AUS,1936,1,0,0,1,Australia
BEL,1936,14,0,0,14,Belgium
SWE,1936,23,9,13,45,Sweden
POL,1936,6,0,6,12,Poland
GER,1940,0,0,0,0,Germany
GER,1944,0,0,0,0,Germany
NOR,1948,17,7,7,31,Norway
TUR,1948,2,6,4,12,Turkey
AUS,1948,5,2,9,16,Australia
IRI,1948,1,0,0,1,Iran
URU,1948,2,0,1,3,Uruguay
DEN,1948,27,7,17,51,Denmark
GBR,1948,14,7,42,63,UK
RSA,1948,2,2,2,6,South Africa
SWE,1948,33,37,18,88,Sweden
EGY,1948,1,2,2,5,Egypt
ESP,1948,0,0,3,3,Spain
NED,1948,32,8,2,42,Netherlands
ARG,1948,1,3,7,11,Argentina
FRA,1948,26,28,23,77,France
PUR,1948,1,0,0,1,Puerto Rico
ITA,1948,14,22,32,68,Italy
CUB,1948,0,0,2,2,Cuba
JAM,1948,0,1,2,3,Jamaica
SRI,1948,0,0,1,1,Sri Lanka
PAN,1948,2,0,0,2,Panama
HUN,1948,22,15,27,64,Hungary
KOR,1948,2,0,0,2,South Korea
AUT,1948,8,3,5,16,Austria
BRA,1948,10,0,0,10,Brazil
PER,1948,0,1,0,1,Peru
TTO,1948,0,0,1,1,Trinidad
FIN,1948,10,18,14,42,Finland
MEX,1948,4,4,1,9,Mexico
TCH,1948,3,14,20,37,Czech Republic
SUI,1948,25,9,30,64,Switzerland
POL,1948,1,1,0,2,Poland
POR,1948,3,0,2,5,Portugal
USA,1948,41,93,34,168,USA
IRL,1948,1,0,0,1,Ireland
YUG,1948,0,0,16,16,Serbia
CAN,1948,7,13,2,22,Canada
BEL,1948,8,7,6,21,Belgium
IND,1948,0,20,0,20,India
LUX,1952,0,1,0,1,Luxembourg
YUG,1952,0,4,20,24,Serbia
IND,1952,1,14,0,15,India
GBR,1952,26,4,2,32,UK
AUT,1952,4,2,5,11,Austria
BUL,1952,1,0,0,1,Bulgaria
DEN,1952,5,3,1,9,Denmark
TTO,1952,2,0,0,2,Trinidad
URS,1952,19,36,62,117,Russia
EGY,1952,1,0,0,1,Egypt
ITA,1952,16,18,22,56,Italy
BEL,1952,0,5,3,8,Belgium
RSA,1952,4,2,8,14,South Africa
IRI,1952,4,0,3,7,Iran
FRA,1952,18,14,9,41,France
POR,1952,2,0,0,2,Portugal
POL,1952,1,1,2,4,Poland
VEN,1952,1,0,0,1,Venezuela
NED,1952,0,0,21,21,Netherlands
ROU,1952,2,1,1,4,Romania
ESP,1952,0,0,1,1,Spain
BRA,1952,2,1,0,3,Brazil
ARG,1952,2,2,2,6,Argentina
HUN,1952,34,53,17,104,Hungary
SUI,1952,18,2,19,39,Switzerland
KOR,1952,2,0,0,2,South Korea
JAM,1952,0,5,3,8,Jamaica
CAN,1952,1,17,3,21,Canada
USA,1952,29,87,48,164,USA
TUR,1952,1,2,0,3,Turkey
AUS,1952,11,7,2,20,Australia
LIB,1952,1,0,1,2,Lebanon
TCH,1952,10,11,4,25,Czech Republic
NZL,1952,2,1,0,3,New Zealand
SWE,1952,46,23,24,93,Sweden
NOR,1952,6,12,14,32,Norway
IRL,1952,0,0,1,1,Ireland
CHI,1952,0,0,4,4,Chile
URU,1952,14,0,0,14,Uruguay
FIN,1952,31,14,7,52,Finland
JPN,1952,2,1,9,12,Japan
GER,1952,28,8,16,52,Germany
MEX,1952,0,0,1,1,Mexico
RSA,1956,7,0,0,7,South Africa
DEN,1956,1,1,4,6,Denmark
NZL,1956,0,3,0,3,New Zealand
URS,1956,61,94,51,206,Russia
HUN,1956,16,30,20,66,Hungary
PAK,1956,0,0,14,14,Pakistan
ISL,1956,0,0,1,1,Iceland
BRA,1956,0,1,0,1,Brazil
ITA,1956,10,28,17,55,Italy
BAH,1956,2,0,0,2,Bahamas
USA,1956,25,63,61,149,USA
IND,1956,0,17,0,17,India
ROU,1956,10,6,3,19,Romania
AUS,1956,26,28,13,67,Australia
FRA,1956,13,7,13,33,France
TUR,1956,2,3,2,7,Turkey
POL,1956,10,1,9,20,Poland
GBR,1956,22,8,16,46,UK
NOR,1956,3,3,1,7,Norway
SUI,1956,5,6,2,13,Switzerland
GRE,1956,1,0,0,1,Greece
JPN,1956,5,4,16,25,Japan
SWE,1956,15,16,18,49,Sweden
AUT,1956,8,5,3,16,Austria
KOR,1956,1,0,1,2,South Korea
FIN,1956,23,8,7,38,Finland
YUG,1956,0,0,23,23,Serbia
TCH,1956,1,1,5,7,Czech Republic
CAN,1956,23,5,11,39,Canada
URU,1956,12,0,0,12,Uruguay
IRL,1956,3,1,1,5,Ireland
MEX,1956,1,1,0,2,Mexico
ARG,1956,1,0,1,2,Argentina
CHI,1956,2,0,2,4,Chile
GER,1956,24,10,20,54,Germany
BUL,1956,14,1,3,18,Bulgaria
BEL,1956,0,0,2,2,Belgium
IRI,1956,1,2,2,5,Iran
ROU,1960,11,3,1,15,Romania
WIF,1960,5,0,0,5,Trinidad
SGP,1960,0,0,1,1,
BEL,1960,2,0,2,4,Belgium
UAR,1960,1,0,1,2,Syria
IRQ,1960,1,0,0,1,Iraq
POR,1960,0,0,2,2,Portugal
JPN,1960,12,9,10,31,Japan
NOR,1960,0,5,6,11,Norway
IND,1960,0,0,13,13,India
RSA,1960,2,0,1,3,South Africa
ETH,1960,0,1,0,1,Ethiopia
TPE,1960,0,0,1,1,Taiwan
VEN,1960,1,0,0,1,Venezuela
PAK,1960,1,13,0,14,Pakistan
POL,1960,16,4,12,32,Poland
GRE,1960,0,3,0,3,Greece
TCH,1960,11,4,8,23,Czech Republic
FIN,1960,9,6,4,19,Finland
YUG,1960,0,16,1,17,Serbia
CAN,1960,1,3,26,30,Canada
MEX,1960,1,0,0,1,Mexico
GBR,1960,15,2,11,28,UK
DEN,1960,4,2,17,23,Denmark
GHA,1960,0,0,1,1,Ghana
GER,1960,23,38,37,98,Germany
ARG,1960,1,0,3,4,Argentina
BUL,1960,3,1,3,7,Bulgaria
HUN,1960,37,13,16,66,Hungary
NZL,1960,1,2,0,3,New Zealand
ITA,1960,35,36,18,89,Italy
URS,1960,73,68,70,211,Russia
SUI,1960,6,2,6,14,Switzerland
SWE,1960,5,7,4,16,Sweden
TUR,1960,0,7,2,9,Turkey
BRA,1960,13,0,0,13,Brazil
USA,1960,25,100,27,152,USA
ESP,1960,14,0,0,14,Spain
FRA,1960,8,1,6,15,France
AUS,1960,11,11,24,46,Australia
AUT,1960,3,2,4,9,Austria
IRI,1960,3,0,1,4,Iran
MAR,1960,0,0,1,1,Morocco
NED,1960,3,0,2,5,Netherlands
URS,1964,60,90,71,221,Russia
TUR,1964,1,2,3,6,Turkey
IRL,1964,1,0,0,1,Ireland
TCH,1964,29,5,37,71,Czech Republic
IRI,1964,2,0,0,2,Iran
IND,1964,0,15,0,15,India
JPN,1964,25,32,5,62,Japan
HUN,1964,7,42,7,56,Hungary
FRA,1964,17,4,17,38,France
TTO,1964,5,0,1,6,Trinidad
GHA,1964,1,0,0,1,Ghana
KOR,1964,1,0,2,3,South Korea
TUN,1964,1,0,1,2,Tunisia
GER,1964,53,25,48,126,Germany
SWE,1964,9,9,25,43,Sweden
GBR,1964,5,6,19,30,UK
KEN,1964,1,0,0,1,Kenya
MEX,1964,1,0,0,1,Mexico
ITA,1964,17,14,30,61,Italy
SUI,1964,1,1,4,6,Switzerland
YUG,1964,2,2,11,15,Serbia
CAN,1964,2,6,4,12,Canada
BUL,1964,2,3,5,10,Bulgaria
PHI,1964,0,0,1,1,Philippines
NGR,1964,1,0,0,1,Nigeria
NED,1964,16,6,11,33,Netherlands
BRA,1964,12,0,0,12,Brazil
POL,1964,23,10,13,46,Poland
DEN,1964,4,7,1,12,Denmark
PAK,1964,0,0,16,16,Pakistan
ROU,1964,10,2,4,16,Romania
AUT,1964,3,5,9,17,Austria
URU,1964,1,0,0,1,Uruguay
ETH,1964,0,1,0,1,Ethiopia
ARG,1964,0,0,1,1,Argentina
NOR,1964,6,3,6,15,Norway
AUS,1964,30,8,6,44,Australia
BAH,1964,0,2,0,2,Bahamas
PRK,1964,0,0,1,1,North Korea
USA,1964,42,96,39,177,USA
NZL,1964,2,4,0,6,New Zealand
BEL,1964,1,2,0,3,Belgium
CUB,1964,0,0,1,1,Cuba
FIN,1964,7,6,7,20,Finland
SWE,1968,7,7,11,25,Sweden
CAN,1968,22,4,4,30,Canada
TCH,1968,16,8,26,50,Czech Republic
KEN,1968,2,3,7,12,Kenya
ITA,1968,20,13,8,41,Italy
JAM,1968,0,0,1,1,Jamaica
GDR,1968,21,15,22,58,Germany
USA,1968,36,100,37,173,USA
CUB,1968,0,0,10,10,Cuba
GRE,1968,1,0,0,1,Greece
MEX,1968,3,3,3,9,Mexico
PAK,1968,0,13,0,13,Pakistan
DEN,1968,6,5,6,17,Denmark
SUI,1968,17,0,5,22,Switzerland
NZL,1968,2,5,0,7,New Zealand
GBR,1968,5,9,5,19,UK
KOR,1968,1,0,1,2,South Korea
TUN,1968,1,1,0,2,Tunisia
NOR,1968,2,15,11,28,Norway
ROU,1968,11,5,9,25,Romania
CMR,1968,0,0,1,1,Cameroon
TUR,1968,0,2,0,2,Turkey
IND,1968,16,0,0,16,India
FIN,1968,6,2,4,12,Finland
VEN,1968,0,1,0,1,Venezuela
UGA,1968,1,0,1,2,Uganda
BEL,1968,2,0,1,3,Belgium
TPE,1968,1,0,0,1,Taiwan
JPN,1968,22,16,25,63,Japan
ETH,1968,0,1,1,2,Ethiopia
MGL,1968,3,0,1,4,Mongolia
FRG,1968,23,19,19,61,Germany
AUT,1968,7,3,10,20,Austria
ARG,1968,2,0,0,2,Argentina
IRI,1968,2,2,1,5,Iran
FRA,1968,12,16,8,36,France
AUS,1968,11,5,35,51,Australia
BRA,1968,3,0,1,4,Brazil
POL,1968,30,5,2,37,Poland
URS,1968,69,91,69,229,Russia
BUL,1968,3,2,21,26,Bulgaria
NED,1968,4,9,10,23,Netherlands
HUN,1968,29,32,20,81,Hungary
YUG,1968,2,13,14,29,Serbia
BUL,1972,6,6,10,22,Bulgaria
PAK,1972,0,0,15,15,Pakistan
AUS,1972,2,11,7,20,Australia
HUN,1972,25,10,46,81,Hungary
IND,1972,14,0,0,14,India
TCH,1972,25,3,21,49,Czech Republic
TUN,1972,0,0,1,1,Tunisia
PRK,1972,13,1,1,15,North Korea
SWE,1972,10,5,11,26,Sweden
COL,1972,2,0,1,3,Colombia
BEL,1972,0,0,2,2,Belgium
NZL,1972,1,9,4,14,New Zealand
AUT,1972,4,1,3,8,Austria
BRA,1972,2,0,0,2,Brazil
KEN,1972,4,5,3,12,Kenya
KOR,1972,0,0,1,1,South Korea
JAM,1972,1,0,0,1,Jamaica
USA,1972,46,72,77,195,USA
GHA,1972,1,0,0,1,Ghana
SUI,1972,7,7,11,25,Switzerland
JPN,1972,9,30,20,59,Japan
CAN,1972,9,0,3,12,Canada
GRE,1972,0,0,2,2,Greece
POL,1972,11,28,8,47,Poland
IRI,1972,1,0,2,3,Iran
ROU,1972,27,3,10,40,Romania
MEX,1972,0,0,1,1,Mexico
LIB,1972,0,0,1,1,Lebanon
ITA,1972,14,12,8,34,Italy
DEN,1972,0,1,0,1,Denmark
NIG,1972,1,0,0,1,Niger
GBR,1972,12,8,9,29,UK
FRG,1972,43,48,21,112,Germany
TUR,1972,0,0,1,1,Turkey
YUG,1972,2,15,1,18,Serbia
URS,1972,63,143,53,259,Russia
CUB,1972,18,3,1,22,Cuba
NED,1972,4,7,4,15,Netherlands
ESP,1972,1,1,0,2,Spain
FRA,1972,17,2,6,25,France
MGL,1972,0,0,1,1,Mongolia
ARG,1972,0,0,1,1,Argentina
NGR,1972,1,0,0,1,Nigeria
FIN,1972,7,3,10,20,Finland
NOR,1972,11,4,10,25,Norway
GDR,1972,69,35,67,171,Germany
UGA,1972,0,1,1,2,Uganda
ETH,1972,2,0,0,2,Ethiopia
PRK,1976,0,1,1,2,North Korea
URS,1976,88,152,102,342,Russia
TTO,1976,0,1,0,1,Trinidad
PAK,1976,16,0,0,16,Pakistan
MEX,1976,1,1,0,2,Mexico
JAM,1976,0,1,1,2,Jamaica
FIN,1976,1,9,12,22,Finland
FRG,1976,55,23,32,110,Germany
VEN,1976,0,0,1,1,Venezuela
BUL,1976,18,8,13,39,Bulgaria
JPN,1976,10,25,6,41,Japan
YUG,1976,3,2,14,19,Serbia
IRI,1976,1,0,1,2,Iran
BRA,1976,3,0,0,3,Brazil
AUT,1976,4,2,2,8,Austria
POR,1976,0,0,2,2,Portugal
ITA,1976,5,3,27,35,Italy
FRA,1976,9,5,7,21,France
BER,1976,1,0,0,1,Bermuda
HUN,1976,35,14,6,55,Hungary
ESP,1976,0,0,6,6,Spain
POL,1976,26,18,29,73,Poland
MGL,1976,0,0,1,1,Mongolia
BEL,1976,6,0,3,9,Belgium
NED,1976,15,1,4,20,Netherlands
PUR,1976,1,0,0,1,Puerto Rico
CAN,1976,15,1,10,26,Canada
LIE,1976,2,0,0,2,Liechtenstein
ROU,1976,23,4,28,55,Romania
GBR,1976,11,7,15,33,UK
CUB,1976,14,6,4,24,Cuba
SUI,1976,8,2,9,19,Switzerland
NOR,1976,1,5,10,16,Norway
TCH,1976,9,2,23,34,Czech Republic
AUS,1976,8,0,15,23,Australia
USA,1976,41,73,61,175,USA
DEN,1976,5,3,0,8,Denmark
KOR,1976,15,1,1,17,South Korea
THA,1976,1,0,0,1,Thailand
NZL,1976,9,15,1,25,New Zealand
SWE,1976,2,9,1,12,Sweden
GDR,1976,56,114,57,227,Germany
MGL,1980,2,0,2,4,Mongolia
ESP,1980,3,2,19,24,Spain
POL,1980,22,3,25,50,Poland
LIE,1980,0,2,2,4,Liechtenstein
LIB,1980,1,0,0,1,Lebanon
JPN,1980,0,0,1,1,Japan
ITA,1980,8,8,24,40,Italy
PRK,1980,2,0,3,5,North Korea
BEL,1980,0,1,0,1,Belgium
SWE,1980,29,6,8,43,Sweden
UGA,1980,0,0,1,1,Uganda
MEX,1980,9,0,1,10,Mexico
AUT,1980,4,4,5,13,Austria
VEN,1980,0,0,1,1,Venezuela
IND,1980,0,16,0,16,India
FIN,1980,11,4,6,21,Finland
ZIM,1980,0,15,0,15,Zimbabwe
GDR,1980,73,131,99,303,Germany
ETH,1980,2,2,0,4,Ethiopia
SUI,1980,3,4,4,11,Switzerland
HUN,1980,40,8,15,63,Hungary
AUS,1980,5,6,2,13,Australia
GRE,1980,4,1,0,5,Greece
URS,1980,133,205,158,496,Russia
DEN,1980,2,4,2,8,Denmark
CAN,1980,1,0,1,2,Canada
NED,1980,6,1,3,10,Netherlands
FRG,1980,6,0,2,8,Germany
GUY,1980,1,0,0,1,Guyana
NOR,1980,9,1,5,15,Norway
TAN,1980,0,0,2,2,Tanzania
IRL,1980,1,0,2,3,Ireland
BUL,1980,39,8,44,91,Bulgaria
ROU,1980,46,7,15,68,Romania
JAM,1980,3,0,0,3,Jamaica
GBR,1980,24,6,18,48,UK
FRA,1980,7,18,5,30,France
YUG,1980,17,13,27,57,Serbia
BRA,1980,5,4,0,9,Brazil
TCH,1980,17,17,18,52,Czech Republic
USA,1980,2,24,4,30,USA
CUB,1980,5,8,7,20,Cuba
JAM,1984,2,0,5,7,Jamaica
IRL,1984,0,0,1,1,Ireland
AUT,1984,2,1,1,4,Austria
TCH,1984,4,0,24,28,Czech Republic
ZAM,1984,1,0,0,1,Zambia
PUR,1984,1,0,1,2,Puerto Rico
THA,1984,0,0,1,1,Thailand
YUG,1984,35,47,6,88,Serbia
ISL,1984,1,0,0,1,Iceland
ROU,1984,35,40,31,106,Romania
ITA,1984,28,31,6,65,Italy
AUS,1984,31,7,14,52,Australia
ALG,1984,2,0,0,2,Algeria
CAN,1984,33,21,37,91,Canada
COL,1984,0,0,1,1,Colombia
CIV,1984,0,0,1,1,Ivory Coast
CMR,1984,1,0,0,1,Cameroon
VEN,1984,3,0,0,3,Venezuela
SUI,1984,8,2,11,21,Switzerland
NOR,1984,7,6,6,19,Norway
GDR,1984,7,13,13,33,Germany
LIE,1984,2,0,0,2,Liechtenstein
GBR,1984,42,11,20,73,UK
NGR,1984,4,0,1,5,Nigeria
DEN,1984,10,0,3,13,Denmark
NED,1984,14,20,7,41,Netherlands
URS,1984,12,29,15,56,Russia
FRG,1984,57,33,76,166,Germany
TUR,1984,3,0,0,3,Turkey
DOM,1984,1,0,0,1,Dominican Republic
MAR,1984,0,2,0,2,Morocco
EGY,1984,0,0,1,1,Egypt
FRA,1984,33,20,17,70,France
ESP,1984,3,2,14,19,Spain
MEX,1984,1,2,3,6,Mexico
FIN,1984,18,8,5,31,Finland
CHN,1984,37,24,13,74,China
SWE,1984,34,10,20,64,Sweden
GRE,1984,1,0,1,2,Greece
KEN,1984,2,1,0,3,Kenya
BRA,1984,2,1,33,36,Brazil
PAK,1984,0,16,0,16,Pakistan
SYR,1984,0,0,1,1,Syria
JPN,1984,31,10,9,50,Japan
BEL,1984,2,1,2,5,Belgium
PER,1984,0,0,1,1,Peru
TPE,1984,1,0,0,1,Taiwan
NZL,1984,6,16,1,23,New Zealand
USA,1984,50,190,121,361,USA
KOR,1984,7,6,28,41,South Korea
POR,1984,2,1,0,3,Portugal
MGL,1988,1,0,0,1,Mongolia
PHI,1988,1,0,0,1,Philippines
JPN,1988,14,4,3,21,Japan
MAR,1988,2,1,0,3,Morocco
POL,1988,10,2,9,21,Poland
MEX,1988,2,0,0,2,Mexico
KOR,1988,12,28,37,77,South Korea
NED,1988,38,6,8,52,Netherlands
JAM,1988,0,0,7,7,Jamaica
SWE,1988,34,7,5,46,Sweden
SUR,1988,0,1,0,1,Suriname
PAK,1988,1,0,0,1,Pakistan
ITA,1988,13,13,11,37,Italy
LIE,1988,1,0,0,1,Liechtenstein
KEN,1988,2,5,2,9,Kenya
NZL,1988,16,4,4,24,New Zealand
NOR,1988,5,2,26,33,Norway
SUI,1988,7,8,13,28,Switzerland
ROU,1988,16,8,34,58,Romania
PER,1988,0,0,12,12,Peru
POR,1988,0,1,0,1,Portugal
SEN,1988,0,0,1,1,Senegal
TCH,1988,8,3,5,16,Czech Republic
YUG,1988,22,15,32,69,Serbia
ARG,1988,12,0,1,13,Argentina
INA,1988,0,0,3,3,Indonesia
ISV,1988,0,0,1,1,"Virgin Islands, US"
DJI,1988,1,0,0,1,Djibouti
ESP,1988,2,1,2,5,Spain
AUS,1988,11,18,6,35,Australia
HUN,1988,15,20,9,44,Hungary
CHN,1988,30,6,16,52,China
CHI,1988,0,0,1,1,Chile
COL,1988,1,0,0,1,Colombia
BRA,1988,5,1,17,23,Brazil
USA,1988,58,89,67,214,USA
GRE,1988,1,0,0,1,Greece
FIN,1988,7,8,23,38,Finland
BEL,1988,2,0,0,2,Belgium
BUL,1988,17,10,14,41,Bulgaria
GDR,1988,55,89,69,213,Germany
FRA,1988,14,13,4,31,France
GBR,1988,15,22,17,54,UK
FRG,1988,49,36,44,129,Germany
TUR,1988,0,1,1,2,Turkey
CAN,1988,18,4,7,29,Canada
IRI,1988,0,0,1,1,Iran
AUT,1988,4,4,5,13,Austria
AHO,1988,0,0,1,1,Curacao
CRC,1988,0,0,1,1,Costa Rica
THA,1988,1,0,0,1,Thailand
DEN,1988,3,3,1,7,Denmark
URS,1988,111,174,81,366,Russia
GBR,1992,39,8,3,50,UK
BAH,1992,1,0,0,1,Bahamas
ETH,1992,2,1,0,3,Ethiopia
KOR,1992,17,33,6,56,South Korea
LUX,1992,0,0,2,2,Luxembourg
PRK,1992,7,4,0,11,North Korea
USA,1992,87,94,57,238,USA
PUR,1992,1,0,0,1,Puerto Rico
PAK,1992,16,0,0,16,Pakistan
GHA,1992,20,0,0,20,Ghana
QAT,1992,1,0,0,1,Qatar
SLO,1992,6,0,0,6,Slovenia
CAN,1992,15,32,33,80,Canada
KEN,1992,2,2,4,8,Kenya
GRE,1992,0,2,0,2,Greece
AUT,1992,10,9,16,35,Austria
BRA,1992,0,13,1,14,Brazil
MGL,1992,2,0,0,2,Mongolia
TCH,1992,28,4,3,35,Czech Republic
MEX,1992,0,0,1,1,Mexico
SWE,1992,13,2,27,42,Sweden
POL,1992,19,5,22,46,Poland
MAS,1992,2,0,0,2,Malaysia
LTU,1992,12,1,0,13,Lithuania
FRA,1992,44,14,11,69,France
CRO,1992,3,0,12,15,Croatia
CUB,1992,14,42,13,69,Cuba
ITA,1992,22,25,19,66,Italy
EUN,1992,81,127,71,279,Russia
PHI,1992,1,0,0,1,Philippines
BEL,1992,2,0,1,3,Belgium
BUL,1992,7,3,7,17,Bulgaria
LAT,1992,1,0,2,3,Latvia
GER,1992,67,95,74,236,Germany
PER,1992,0,0,1,1,Peru
FIN,1992,8,7,5,20,Finland
SUR,1992,1,0,0,1,Suriname
TUR,1992,2,2,2,6,Turkey
NAM,1992,0,0,2,2,Namibia
JAM,1992,1,0,3,4,Jamaica
IRL,1992,0,1,1,2,Ireland
ESP,1992,3,48,19,70,Spain
NGR,1992,4,0,7,11,Nigeria
JPN,1992,43,6,10,59,Japan
TPE,1992,0,0,20,20,Taiwan
THA,1992,1,0,0,1,Thailand
INA,1992,1,2,3,6,Indonesia
NED,1992,10,6,21,37,Netherlands
ARG,1992,2,0,0,2,Argentina
DEN,1992,9,3,2,14,Denmark
RSA,1992,0,0,3,3,South Africa
COL,1992,1,0,0,1,Colombia
IOA,1992,2,0,1,3,Individual Olympic Athletes
SUI,1992,5,3,0,8,Switzerland
ALG,1992,1,1,0,2,Algeria
IRI,1992,2,0,1,3,Iran
AUS,1992,16,14,27,57,Australia
CHN,1992,19,18,48,85,China
MAR,1992,1,1,1,3,Morocco
EST,1992,2,1,0,3,Estonia
ISR,1992,1,0,1,2,Israel
NOR,1992,6,11,30,47,Norway
ROU,1992,14,8,31,53,Romania
HUN,1992,8,14,23,45,Hungary
NZL,1992,5,1,10,16,New Zealand
MAS,1996,1,0,2,3,Malaysia
FRA,1996,20,21,10,51,France
CRO,1996,0,16,12,28,Croatia
CZE,1996,4,4,5,13,Czech Republic
MOZ,1996,1,0,0,1,Mozambique
BRA,1996,43,5,15,63,Brazil
NOR,1996,18,2,3,23,Norway
SVK,1996,1,1,1,3,Slovakia
NED,1996,26,38,9,73,Netherlands
ESP,1996,22,23,21,66,Spain
CAN,1996,12,8,30,50,Canada
UKR,1996,19,10,5,34,Ukraine
UGA,1996,1,0,0,1,Uganda
NGR,1996,3,17,4,24,Nigeria
DEN,1996,1,21,1,23,Denmark
MGL,1996,1,0,0,1,Mongolia
ETH,1996,1,2,0,3,Ethiopia
CHN,1996,17,19,70,106,China
MEX,1996,1,0,0,1,Mexico
BUL,1996,6,3,12,21,Bulgaria
ECU,1996,0,1,0,1,Ecuador
CRC,1996,0,1,0,1,Costa Rica
NAM,1996,0,0,2,2,Namibia
FIN,1996,1,1,2,4,Finland
SUI,1996,0,5,6,11,Switzerland
USA,1996,52,159,48,259,USA
PHI,1996,0,0,1,1,Philippines
MDA,1996,1,0,2,3,Moldova
TUR,1996,1,4,1,6,Turkey
NZL,1996,4,3,2,9,New Zealand
CUB,1996,10,37,8,55,Cuba
UZB,1996,1,0,1,2,Uzbekistan
AZE,1996,0,0,1,1,Azerbaijan
PUR,1996,1,0,0,1,Puerto Rico
AUT,1996,2,0,1,3,Austria
KEN,1996,3,1,4,8,Kenya
GRE,1996,0,4,4,8,Greece
TTO,1996,2,0,0,2,Trinidad
MAR,1996,2,0,0,2,Morocco
HKG,1996,0,1,0,1,China
AUS,1996,84,32,16,132,Australia
KAZ,1996,4,3,4,11,Kazakhstan
ROU,1996,15,13,10,38,Romania
HUN,1996,26,8,9,43,Hungary
ARM,1996,0,1,1,2,Armenia
JPN,1996,13,3,26,42,Japan
ARG,1996,1,0,19,20,Argentina
TPE,1996,0,0,1,1,Taiwan
INA,1996,3,2,1,6,Indonesia
SCG,1996,13,1,12,26,Serbia
ISR,1996,1,0,0,1,Israel
ITA,1996,28,19,24,71,Italy
SLO,1996,0,0,2,2,Slovenia
TGA,1996,0,0,1,1,Tonga
IRL,1996,1,3,0,4,Ireland
PRK,1996,2,2,1,5,North Korea
THA,1996,1,1,0,2,Thailand
IRI,1996,1,1,1,3,Iran
JAM,1996,12,1,3,16,Jamaica
ALG,1996,1,2,0,3,Algeria
RSA,1996,1,3,1,5,South Africa
ZAM,1996,0,0,1,1,Zambia
IND,1996,1,0,0,1,India
RUS,1996,34,36,45,115,Russia
KOR,1996,7,10,49,66,South Korea
SYR,1996,0,1,0,1,Syria
BEL,1996,2,2,2,6,Belgium
LAT,1996,0,0,1,1,Latvia
POR,1996,2,1,0,3,Portugal
TUN,1996,1,0,0,1,Tunisia
SWE,1996,5,3,23,31,Sweden
BDI,1996,0,1,0,1,Burundi
GEO,1996,2,0,0,2,Georgia
BLR,1996,16,1,6,23,Belarus
GER,1996,47,42,35,124,Germany
BAH,1996,0,0,5,5,Bahamas
POL,1996,7,7,8,22,Poland
GBR,1996,9,2,15,26,UK
LTU,1996,11,0,0,11,Lithuania
BAH,2000,5,6,0,11,Bahamas
RUS,2000,54,66,67,187,Russia
SRI,2000,0,0,1,1,Sri Lanka
COL,2000,0,1,0,1,Colombia
QAT,2000,1,0,0,1,Qatar
ARM,2000,1,0,0,1,Armenia
BUL,2000,2,5,6,13,Bulgaria
CRC,2000,2,0,0,2,Costa Rica
AZE,2000,1,2,0,3,Azerbaijan
UZB,2000,2,1,1,4,Uzbekistan
PRK,2000,3,0,1,4,North Korea
SCG,2000,13,11,1,25,Serbia
CRO,2000,9,1,0,10,Croatia
AUT,2000,0,3,1,4,Austria
POL,2000,7,7,10,24,Poland
BRA,2000,36,0,12,48,Brazil
POR,2000,2,0,0,2,Portugal
CHI,2000,17,0,0,17,Chile
ARG,2000,3,0,17,20,Argentina
CHN,2000,17,39,23,79,China
BAR,2000,1,0,0,1,Barbados
CMR,2000,0,18,0,18,Cameroon
NZL,2000,3,1,0,4,New Zealand
USA,2000,51,130,61,242,USA
AUS,2000,54,60,69,183,Australia
CAN,2000,23,4,4,31,Canada
ALG,2000,3,1,1,5,Algeria
BEL,2000,4,0,3,7,Belgium
RSA,2000,3,0,2,5,South Africa
SLO,2000,0,3,0,3,Slovenia
NOR,2000,19,20,4,43,Norway
ROU,2000,13,27,6,46,Romania
BLR,2000,11,3,8,22,Belarus
VIE,2000,0,0,1,1,Vietnam
DEN,2000,4,18,3,25,Denmark
LAT,2000,1,1,1,3,Latvia
ESP,2000,20,3,19,42,Spain
INA,2000,2,2,4,8,Indonesia
TPE,2000,4,0,1,5,Taiwan
FRA,2000,14,22,30,66,France
JPN,2000,8,5,31,44,Japan
UKR,2000,12,3,20,35,Ukraine
EST,2000,2,1,0,3,Estonia
MOZ,2000,0,1,0,1,Mozambique
GBR,2000,12,22,20,54,UK
MKD,2000,1,0,0,1,Macedonia
SVK,2000,1,2,3,6,Slovakia
LTU,2000,15,2,0,17,Lithuania
HUN,2000,4,25,24,53,Hungary
KUW,2000,1,0,0,1,Kuwait
KAZ,2000,0,3,4,7,Kazakhstan
KOR,2000,35,12,26,73,South Korea
MEX,2000,3,1,2,6,Mexico
ETH,2000,3,4,1,8,Ethiopia
FIN,2000,1,3,1,5,Finland
GRE,2000,8,4,6,18,Greece
KEN,2000,2,2,3,7,Kenya
KGZ,2000,1,0,0,1,Kyrgyzstan
TUR,2000,2,3,0,5,Turkey
MDA,2000,1,0,1,2,Moldova
MAR,2000,4,0,1,5,Morocco
IND,2000,1,0,0,1,India
CUB,2000,12,18,35,65,Cuba
TTO,2000,1,0,1,2,Trinidad
GER,2000,64,31,23,118,Germany
SWE,2000,8,4,20,32,Sweden
NGR,2000,0,6,2,8,Nigeria
SUI,2000,2,1,11,14,Switzerland
ITA,2000,29,22,14,65,Italy
ISL,2000,1,0,0,1,Iceland
IRL,2000,0,0,1,1,Ireland
CZE,2000,4,2,3,9,Czech Republic
URU,2000,0,0,1,1,Uruguay
IRI,2000,1,3,0,4,Iran
THA,2000,2,1,0,3,Thailand
NED,2000,23,27,29,79,Netherlands
JAM,2000,3,0,20,23,Jamaica
GEO,2000,6,0,0,6,Georgia
ISR,2000,1,0,0,1,Israel
KSA,2000,1,0,1,2,Saudi Arabia
AUT,2004,1,3,4,8,Austria
TTO,2004,1,0,0,1,Trinidad
BAH,2004,1,1,0,2,Bahamas
GER,2004,63,41,45,149,Germany
AZE,2004,4,1,0,5,Azerbaijan
POR,2004,1,0,2,3,Portugal
PRK,2004,1,0,4,5,North Korea
VEN,2004,2,0,0,2,Venezuela
KOR,2004,10,14,28,52,South Korea
CUB,2004,22,32,8,62,Cuba
SWE,2004,2,5,5,12,Sweden
ISR,2004,1,1,0,2,Israel
ITA,2004,39,24,41,104,Italy
ZIM,2004,1,1,1,3,Zimbabwe
RUS,2004,95,48,46,189,Russia
IRI,2004,2,2,2,6,Iran
JAM,2004,6,6,1,13,Jamaica
SLO,2004,3,0,2,5,Slovenia
RSA,2004,3,4,3,10,South Africa
THA,2004,4,3,1,8,Thailand
IND,2004,0,0,1,1,India
INA,2004,3,1,1,5,Indonesia
HUN,2004,4,24,12,40,Hungary
ARG,2004,21,28,0,49,Argentina
JPN,2004,52,21,20,93,Japan
ROU,2004,11,23,5,39,Romania
KAZ,2004,3,1,4,8,Kazakhstan
HKG,2004,0,0,2,2,China
SYR,2004,1,0,0,1,Syria
AUS,2004,31,49,77,157,Australia
GRE,2004,5,8,18,31,Greece
KEN,2004,2,1,4,7,Kenya
SCG,2004,0,0,13,13,Serbia
TPE,2004,3,2,4,9,Taiwan
GBR,2004,15,17,25,57,UK
USA,2004,71,117,75,263,USA
TUR,2004,5,3,3,11,Turkey
DEN,2004,9,19,1,29,Denmark
CHN,2004,15,52,27,94,China
DOM,2004,0,1,0,1,Dominican Republic
UAE,2004,0,1,0,1,United Arab Emirates
EGY,2004,3,1,1,5,Egypt
FIN,2004,0,0,2,2,Finland
ETH,2004,2,2,3,7,Ethiopia
ERI,2004,1,0,0,1,Eritrea
PAR,2004,0,0,17,17,Paraguay
BUL,2004,14,2,1,17,Bulgaria
ESP,2004,9,4,17,30,Spain
MEX,2004,1,0,3,4,Mexico
CHI,2004,1,3,0,4,Chile
LAT,2004,0,0,4,4,Latvia
MGL,2004,1,0,0,1,Mongolia
UKR,2004,31,8,8,47,Ukraine
SVK,2004,5,3,2,10,Slovakia
CAN,2004,4,3,10,17,Canada
NZL,2004,0,4,2,6,New Zealand
BRA,2004,3,18,19,40,Brazil
EST,2004,2,0,1,3,Estonia
CMR,2004,0,1,0,1,Cameroon
GEO,2004,0,2,2,4,Georgia
BEL,2004,2,1,0,3,Belgium
CRO,2004,3,15,3,21,Croatia
CZE,2004,6,1,6,13,Czech Republic
COL,2004,2,0,0,2,Colombia
POL,2004,6,4,2,12,Poland
NGR,2004,8,0,0,8,Nigeria
MAR,2004,0,2,1,3,Morocco
BLR,2004,8,2,5,15,Belarus
LTU,2004,0,1,2,3,Lithuania
SUI,2004,4,1,2,7,Switzerland
UZB,2004,2,2,1,5,Uzbekistan
NOR,2004,2,5,0,7,Norway
FRA,2004,22,21,10,53,France
NED,2004,22,4,51,77,Netherlands
TUN,2008,0,1,0,1,Tunisia
UZB,2008,3,1,2,6,Uzbekistan
SGP,2008,0,0,3,3,
SVK,2008,1,4,5,10,Slovakia
VEN,2008,1,0,0,1,Venezuela
TPE,2008,4,0,0,4,Taiwan
THA,2008,0,2,2,4,Thailand
TJK,2008,1,0,1,2,Tajikistan
TTO,2008,0,5,1,6,Trinidad
VIE,2008,0,0,1,1,Vietnam
UKR,2008,16,10,5,31,Ukraine
USA,2008,80,127,110,317,USA
SLO,2008,2,1,2,5,Slovenia
TUR,2008,3,1,3,7,Turkey
SUD,2008,0,0,1,1,Sudan
TOG,2008,1,0,0,1,Togo
SWE,2008,2,0,5,7,Sweden
SUI,2008,7,3,1,11,Switzerland
SRB,2008,14,0,1,15,Serbia
AFG,2008,1,0,0,1,Afghanistan
ZIM,2008,0,1,3,4,Zimbabwe
LAT,2008,1,1,1,3,Latvia
LTU,2008,3,0,2,5,Lithuania
MAR,2008,1,0,1,2,Morocco
CZE,2008,0,3,4,7,Czech Republic
MAS,2008,0,0,1,1,Malaysia
MDA,2008,1,0,0,1,Moldova
GRE,2008,4,0,3,7,Greece
MEX,2008,2,2,0,4,Mexico
DEN,2008,6,6,7,19,Denmark
MGL,2008,0,2,2,4,Mongolia
BLR,2008,16,8,5,29,Belarus
GER,2008,41,42,16,99,Germany
MRI,2008,1,0,0,1,Mauritius
NED,2008,4,39,18,61,Netherlands
GEO,2008,3,3,0,6,Georgia
BEL,2008,0,1,4,5,Belgium
DOM,2008,0,1,1,2,Dominican Republic
HUN,2008,3,16,8,27,Hungary
BRA,2008,30,14,34,78,Brazil
INA,2008,3,2,2,7,Indonesia
KOR,2008,26,41,11,78,South Korea
COL,2008,1,0,1,2,Colombia
ISL,2008,0,0,14,14,Iceland
ISR,2008,1,0,0,1,Israel
CMR,2008,0,1,0,1,Cameroon
ITA,2008,20,8,14,42,Italy
IRI,2008,1,1,0,2,Iran
CRO,2008,3,0,2,5,Croatia
JAM,2008,6,5,3,14,Jamaica
NGR,2008,7,0,16,23,Nigeria
CHN,2008,57,74,53,184,China
CHI,2008,0,0,1,1,Chile
KAZ,2008,7,2,4,13,Kazakhstan
CAN,2008,11,11,13,35,Canada
IND,2008,2,1,0,3,India
CUB,2008,11,2,34,47,Cuba
KEN,2008,5,6,4,15,Kenya
BUL,2008,3,1,1,5,Bulgaria
KGZ,2008,1,0,1,2,Kyrgyzstan
JPN,2008,13,23,15,51,Japan
BAH,2008,1,0,6,7,Bahamas
IRL,2008,2,0,1,3,Ireland
POL,2008,1,6,13,20,Poland
ALG,2008,1,0,1,2,Algeria
EGY,2008,1,0,0,1,Egypt
NOR,2008,1,16,5,22,Norway
RSA,2008,0,0,1,1,South Africa
RUS,2008,53,43,46,142,Russia
FRA,2008,28,25,24,77,France
PRK,2008,3,2,1,6,North Korea
FIN,2008,2,1,2,5,Finland
AUS,2008,76,31,42,149,Australia
PAN,2008,0,1,0,1,Panama
EST,2008,0,1,2,3,Estonia
GBR,2008,25,31,25,81,UK
ARG,2008,31,20,0,51,Argentina
POR,2008,0,1,1,2,Portugal
NZL,2008,9,4,2,15,New Zealand
ROU,2008,16,5,1,22,Romania
ARM,2008,6,0,0,6,Armenia
AZE,2008,4,1,2,7,Azerbaijan
ETH,2008,2,4,1,7,Ethiopia
ECU,2008,0,0,1,1,Ecuador
ESP,2008,16,7,47,70,Spain
AUT,2008,2,0,1,3,Austria
CRO,2012,16,15,4,35,Croatia
IRI,2012,3,4,5,12,Iran
IND,2012,4,0,2,6,India
THA,2012,1,0,2,3,Thailand
ETH,2012,3,3,1,7,Ethiopia
TJK,2012,1,0,0,1,Tajikistan
ESP,2012,25,5,33,63,Spain
DOM,2012,0,1,1,2,Dominican Republic
INA,2012,1,0,1,2,Indonesia
GBR,2012,48,48,30,126,UK
TUN,2012,1,1,1,3,Tunisia
GEO,2012,3,1,3,7,Georgia
DEN,2012,8,3,5,16,Denmark
COL,2012,4,1,3,8,Colombia
TTO,2012,5,1,4,10,Trinidad
GER,2012,22,45,27,94,Germany
CZE,2012,6,4,4,14,Czech Republic
GAB,2012,0,0,1,1,Gabon
TUR,2012,1,2,2,5,Turkey
GRE,2012,3,0,0,3,Greece
EGY,2012,0,0,2,2,Egypt
FRA,2012,22,30,30,82,France
CYP,2012,0,0,1,1,Cyprus
TPE,2012,1,0,1,2,Taiwan
GUA,2012,0,0,1,1,Guatemala
HUN,2012,6,12,8,26,Hungary
CUB,2012,6,5,3,14,Cuba
UKR,2012,12,9,5,26,Ukraine
FIN,2012,4,0,1,5,Finland
GRN,2012,0,1,0,1,Grenada
HKG,2012,1,0,0,1,China
KEN,2012,5,2,4,11,Kenya
ITA,2012,30,16,22,68,Italy
MNE,2012,0,0,14,14,Montenegro
UZB,2012,2,1,0,3,Uzbekistan
BEL,2012,2,0,1,3,Belgium
SUI,2012,0,2,2,4,Switzerland
NED,2012,19,21,29,69,Netherlands
BAH,2012,0,4,0,4,Bahamas
AZE,2012,6,2,2,10,Azerbaijan
NOR,2012,1,15,1,17,Norway
VEN,2012,0,1,0,1,Venezuela
NZL,2012,15,9,3,27,New Zealand
POL,2012,8,2,2,12,Poland
POR,2012,0,0,2,2,Portugal
IRL,2012,3,1,1,5,Ireland
AUS,2012,59,18,37,114,Australia
PUR,2012,1,0,1,2,Puerto Rico
QAT,2012,2,0,0,2,Qatar
ARM,2012,2,0,1,3,Armenia
SRB,2012,14,1,1,16,Serbia
ROU,2012,6,2,8,16,Romania
ARG,2012,3,1,15,19,Argentina
SLO,2012,3,1,1,5,Slovenia
ALG,2012,0,1,0,1,Algeria
RSA,2012,1,6,2,9,South Africa
RUS,2012,51,50,39,140,Russia
AFG,2012,1,0,0,1,Afghanistan
SGP,2012,4,0,0,4,
PRK,2012,2,4,0,6,North Korea
SVK,2012,4,0,1,5,Slovakia
MGL,2012,3,0,2,5,Mongolia
BRA,2012,11,14,34,59,Brazil
CHN,2012,29,56,40,125,China
JAM,2012,8,8,9,25,Jamaica
JPN,2012,33,7,44,84,Japan
KAZ,2012,5,7,1,13,Kazakhstan
CAN,2012,33,1,21,55,Canada
BUL,2012,1,0,1,2,Bulgaria
SWE,2012,3,2,17,22,Sweden
EST,2012,1,0,1,2,Estonia
KOR,2012,30,18,13,61,South Korea
BRN,2012,1,0,0,1,Bahrain
BLR,2012,8,3,12,23,Belarus
KSA,2012,4,0,0,4,Saudi Arabia
UGA,2012,0,1,0,1,Uganda
KUW,2012,1,0,0,1,Kuwait
LAT,2012,2,1,0,3,Latvia
BOT,2012,0,0,1,1,Botswana
LTU,2012,2,2,1,5,Lithuania
MAR,2012,1,0,0,1,Morocco
USA,2012,46,145,57,248,USA
MEX,2012,3,16,5,24,Mexico
MAS,2012,1,0,1,2,Malaysia
MDA,2012,2,0,0,2,Moldova
MEX,2016,2,0,3,5,Mexico
MGL,2016,1,0,1,2,Mongolia
BEL,2016,2,2,17,21,Belgium
BAH,2016,5,1,0,6,Bahamas
USA,2016,71,139,54,264,USA
SVK,2016,0,3,5,8,Slovakia
SUI,2016,2,6,3,11,Switzerland
UZB,2016,7,4,2,13,Uzbekistan
LTU,2016,5,0,2,7,Lithuania
BLR,2016,7,1,4,12,Belarus
BDI,2016,0,0,1,1,Burundi
MAS,2016,1,0,7,8,Malaysia
MAR,2016,1,0,0,1,Morocco
NED,2016,13,9,25,47,Netherlands
ETH,2016,5,1,2,8,Ethiopia
AZE,2016,10,1,7,18,Azerbaijan
SGP,2016,0,1,0,1,
RSA,2016,14,2,7,23,South Africa
ROU,2016,10,4,2,16,Romania
ALG,2016,0,0,2,2,Algeria
SLO,2016,1,1,2,4,Slovenia
ARG,2016,0,21,1,22,Argentina
SRB,2016,13,14,27,54,Serbia
QAT,2016,0,0,1,1,Qatar
ARM,2016,0,1,3,4,Armenia
PUR,2016,0,1,0,1,Puerto Rico
PRK,2016,2,2,3,7,North Korea
POR,2016,1,0,0,1,Portugal
POL,2016,10,3,3,16,Poland
AUS,2016,25,23,34,82,Australia
PHI,2016,0,0,1,1,Philippines
NZL,2016,5,6,25,36,New Zealand
VIE,2016,0,1,1,2,Vietnam
AUT,2016,2,0,0,2,Austria
NOR,2016,19,0,0,19,Norway
VEN,2016,2,0,1,3,Venezuela
NIG,2016,0,0,1,1,Niger
NGR,2016,18,0,0,18,Nigeria
KOS,2016,0,1,0,1,Kosovo
KEN,2016,1,6,6,13,Kenya
BRA,2016,6,36,8,50,Brazil
TPE,2016,4,1,0,5,Taiwan
RUS,2016,35,52,28,115,Russia
GRE,2016,3,3,1,7,Greece
GER,2016,67,49,43,159,Germany
CZE,2016,12,1,2,15,Czech Republic
TTO,2016,1,0,0,1,Trinidad
GEO,2016,4,2,1,7,Georgia
DEN,2016,16,15,10,41,Denmark
TUN,2016,3,0,0,3,Tunisia
GBR,2016,26,64,55,145,UK
DOM,2016,1,0,0,1,Dominican Republic
FRA,2016,21,20,55,96,France
UKR,2016,5,2,8,15,Ukraine
FIN,2016,1,0,0,1,Finland
EGY,2016,3,0,0,3,Egypt
TUR,2016,4,1,3,8,Turkey
UAE,2016,1,0,0,1,United Arab Emirates
ESP,2016,17,9,19,45,Spain
FIJ,2016,0,13,0,13,Fiji
CUB,2016,4,5,2,11,Cuba
HUN,2016,7,12,3,22,Hungary
INA,2016,0,2,2,4,Indonesia
CRO,2016,2,7,15,24,Croatia
BRN,2016,0,1,1,2,Bahrain
EST,2016,4,0,0,4,Estonia
BUL,2016,6,0,1,7,Bulgaria
SWE,2016,3,2,23,28,Sweden
KAZ,2016,10,3,5,18,Kazakhstan
JPN,2016,34,17,13,64,Japan
CAN,2016,61,4,4,69,Canada
JOR,2016,0,1,0,1,Jordan
JAM,2016,2,11,17,30,Jamaica
KOR,2016,10,13,3,26,South Korea
ITA,2016,24,8,40,72,Italy
CIV,2016,1,1,0,2,Ivory Coast
ISR,2016,2,0,0,2,Israel
IRL,2016,0,0,3,3,Ireland
IRI,2016,4,3,1,8,Iran
COL,2016,3,3,2,8,Colombia
IOA,2016,1,1,0,2,Individual Olympic Athletes
IND,2016,1,0,1,2,India
THA,2016,2,2,2,6,Thailand
TJK,2016,0,1,0,1,Tajikistan
CHN,2016,37,46,30,113,China
GRN,2016,0,0,1,1,Grenada